1111111
100P001
1111101
10E0C01
1111111