1111111
100P001
1111111
10E0C01
1111111S