1111111
1P0C001
1000C01
1000001
1111111