1111111
1000001
1010C01
10E0P01
1111111