1111111
1P00001
1010C01
10E0001
1111111